|||||||||||
|G********|
|*********|
|**p******|
|||||||||||